0000000000000000000000000000000000000000000000000000000000000000000000000000000000000000000000000
1111111111111111111111111000000000000000000000000000000000000000000000000000000000000000000000000
0000000000000000000000001111111111111111000000000000000000000000000000000000000000000000000000000
0000000000000000000000001100000000000001000000000000000000000000000000000000000000000000000000000
0000000000000000000000000000000000000051000000000000000000000000000000000000000000000000000000000
1111111111111166666611111111113313311661000000000000000000000000000000000000000000000000000000000
0000000000000100000010000000000000001001000000000000000000000000000000000000000000000000000000000
0000000000000100000010000000000000001001000000000000000000000000000000000000000000000000000000000
0000000000000100000010000000000000010001000000000000000000000000000000000000000000000000000000000
0000000000000100000000000000000000100010000000000000000000000000000000000000000000000000000000000
0000000000000100000000000000000000000100000000000000000000000000000000000000000000000000000000000
0000000000000111111111111000000011111000000000000000000000000000000000000000000000000000000000000
0000000000000000000000001000000010000000000000000000000000000000000000000000000000000000000000000
0000000000000000000000001000022210000000000000000000000000000000000000000000000000000000000000000
0000000000000000000000001000000010000000000000000000000000000000000000000000000000000000000000000
0000000000000000000000001000000010000000000000000000000000000000000000000000000000000000000000000
0000000000000000000000001000000010000000000000000000000000000000000000000000000000000000000000000
0000000000000000000000001222000010000000000000000000000000000000000000000000000000000000000000000
0000000000000000000000001000000000000000000440000000000000000000000000000000000000000000000000000
0000000000000000000000001008000800808080800440000000000000000000000000000000000000000000000000000
0000000000000000000000001111111111111111111111000000000000000000000000000000000000000000000000000