0000000000000000000000000000000000000000000000000000000000000000000000000000000000000000000000000
1111111111111111111111111000000000000000000000000000000000000000000000000000000000000000000000000
0000000000000000000000001000000000000000000000000000000000000000000000000000000000000000000000000
0000000000000000000000001000000000000000000000000000000000000000000000000000000000000000000000000
0000000000000000000000001000000000000000000000000000000000000000000000000000000000000000000000000
1111111111111000000011111000000000000000000000000000000000000000000000000000000000000000000000000
0000010000001000000000000000000000000000000000000000000000000000000000000000000000000000000000000
0000010000006000000000000000000000000000000000000000000000000000000000000000000000000000000000000
0000010000006000000000000000000000000000100000000000000000000000000000000000000000000000000000000
0000014400006000000000000000000010000000000000001000000000000000000000000000000000000000000000000
0000014400006000000000000000000000000000000000000000000000000000000000000000000000000000000000000
0000011111111111111111111222222222222222222222222222111111111111000000000000000000000000000000000
0000000000001000000000000000000000000000000000000000000000000000000000000000000000000000000000000
0000000000001000000000000000000000000000000000000000000000000000000000000000000000000000000000000
0000000000001000000000000000000000000000000000000000000000000000001110000000000000000000000000000
0000000000001550000000000000000000000000000000000000000000000000000000000000000000000000000000000
0000000000001550000000000000000000000000000000000000000000000000000000000000000000000000000000000
0000000000001111111111111110000000000000000000000001111111111111000000000000000000000000000000000
0000000000000000000000000100000000000011000000000000100000000000000000000000000000000000000000000
0000000000000000000000000100000100000000000000100000100000000000000000000000000000000000000000000
0000000000000000000000000100000000000000000000000000100000000000000000000000000000000000000000000
0000000000000000000000000133333333333333333333333333100000000000000000000000000000000000000000000
0000000000000000000000000000000000000000000000000000000000000000000000000000000000000000000000000
0000000000000000000000000000000000000000000000000000000000000000000000000000000000000000000000000
0000000000000000000000000000000000000000000000000000000000000000000000000000000000000000000000000
0000000000000000000000000000000000000000000000000000000000000000000000000000000000000000000000000
0000000000000000000000000000000000000000000000000000000000000000000000000000000000000000000000000
0000000000000000000000000000000000000000000000000000000000000000000000000000000000000000000000000