00000000000000000000000000000000000000000000000000000000000000000000000000000000000000000000000000000000000000000000000000000000000000000000
00000000000000000000000000000000000000000000000000000000000000000000000000000000000000000000000000000000000000000000000000000000000000000000
00000000000000000000000000000000000000000000000000000000000000000000000000000000000000000000000000000000000000000000000000000000000000000000
00000000000000000000000000000000000000000000000000000000000000000000000000000000000000000000000000000000000000000000000000000000000000000000
00000000000000000000000000000000000110000000000000000000000000000000000000000000000000000000000000000000000000000000000000000000000000000000
00000000000000000000000000000000001111000000011111111111111000000000000000000000000000000000000000000000000000000000000000000000000000000000
00000000000000011111111111000000011111100000011331133113311000000000000000000000000000000000000000000000000000000000000000000000000000000000
00000000000000011212121211000000111111110000011111100000006000000000000000050000000000000000000000000000000000000000000000000000000000000000
11111111100000011212121211000000111111110000011111100000006000000011111111111000000000000000000000000000000000000000000000000000000000000000
13311133100000011212121211000000111111110000011111400000006000000012121212121000000000000000000000000000000000000000000000000000000000000000
13311133100000011212121211000000111111110000011111400000006000000011111111111000000000000000000000000000000000000000000000000000000000000000
11111111100000011212121211000000111111110000011111111111111000000012121212121000000000000000000000000000000000000000000000000000000000000000
13311133100000011212121211000000111111110000011111111111111000000011111111111000000000000000000000000000000000000000000000000000000000000000
13311133100000011212121211000000111111110000011111111111111000000012121212121000000000000000000000000000000000000000000000000000000000000000
11111111100000011212121211000000111111110000011111111111111000000011111111111000000000000000000000000000000000000000000000000000000000000000
11111111100000011212121211000000111111110000011111111111111000000012121212121000000000000000000000000000000000000000000000000000000000000000