00000000000000000000000000000000000000000000000000000000000000000000000000000000000000000000000000000000000000000000000000000000000000000000
00000000000000000000000000000000000000000000000000000000000000000000000000000000000000000000000000000000000000000000000000000000000000000000
00000000000000000000000000000000000000000000000000000000000000000000000000000000000000000000000000000000000000000000000000000000000000000000
00000000000000000000000000000000000000000000000000000000000000000000000000000000000000000000000000000000000000000000000000000000000000000000
00000000000000000000000000000000000110000000000000000000000000000000000000000000000000000000000000000000000000000000000000000000000000000000
00000000000000000000000000000000001111000000011111111111111000000000000000000000000000000000000000000000000000000000000000000000000000000000
00000000000000011111111111000000011111100000011771177117711000000000000000000000000000000000000000000000000000000000000000000000000000000000
00000000000000011717171711000000111111110000011771100000006000000000000000050000000000000000000000000000000000000000000000000000000000000000
11111111100000011717171711000000111111110000011111100000006000000011111111111000000000000000000000000000000000000000000000000000000000000000
17711177100000011717171711000000111111110000011771400000006000000017171717171000000000000000000000000000000000000000000000000000000000000000
17711177100000011717171711000000111111110000011771400000006000000011111111111000000000000000000000000000000000000000000000000000000000000000
11111111100000011717171711000000111111110000011111111111111000000017171717171000000000000000000000000000000000000000000000000000000000000000
17711177100000011717171711000000111111110000011771177117711000000011111111111000000000000000000000000000000000000000000000000000000000000000
17711177100000011717171711000000111111110000011771177117711000000017171717171000000000000000000000000000000000000000000000000000000000000000
11111111100000011717171711000000111111110000011111111111111000000011111111111000000000000000000000000000000000000000000000000000000000000000
11111111100000011717171711000000111111110000011111111111111000000017171717171000000000000000000000000000000000000000000000000000000000000000