0000000000000000000000000000000000000000000000000
0000000000000000000000000000000000000000000000000
0000000000000000000000000000000000000000000000000
0000000000000000000000000000000000000000000000000
0000000000000001000000000000000000000000000000000
0000000000650001000000000000000000000000000000000
0000001000650001000000000000000000000000000000000
0000001000650001000000000000000000000000000000000
1111111111111111111111222222221111133111111111411
0000000000000000000001222222221000133100000001110
0000000000000000000001222222221000133100000000000
0000000000000000000001222222221000133100000000000
0000000000000000000001111111111000111100000000000